#############
#.....S.....#
..#######.#.#
#.......#.#.#
#.#.#####.#.#
#.#.....#.#.#
#.#.###.#####
#.#...#.....#
#.#.#.#####.#
#.#.#....T#.#
#.###.#.#####
#...#.#......
#############
